{
    "width": 9,
    "height": 9,
    "tilesheet": "res/assets/tiles/tilesheet2.png",
    "tilewidth": 64,
    "tilesheet_width": 10,
    "tilesheet_height": 10,
    "tilemap": [5, 5, 5, 5, 5, 5, 5, 5, 5,
                5, 5, 5, 5, 5, 5, 5, 5, 5,
                7, 7, 7, 7, 5, 7, 7, 7, 5,
                7, 7, 5, 7, 7, 7, 7, 7, 7,
                7, 7, 7, 7, 7, 7, 7, 5, 7,
                7, 7, 7, 5, 7, 7, 7, 7, 7,
                5, 7, 7, 7, 7, 7, 7, 7, 5,
                5, 7, 7, 7, 5, 7, 5, 7, 7,
                7, 7, 5, 7, 7, 7, 7, 5, 7],
    "collisionmap":[1, 1, 1, 1, 1, 1, 1, 1, 1,
                    1, 1, 1, 1, 1, 1, 1, 1, 1,
                    0, 0, 0, 0, 1, 0, 0, 0, 1,
                    0, 0, 1, 0, 0, 0, 0, 0, 0,
                    0, 0, 0, 0, 0, 0, 0, 1, 0,
                    0, 0, 0, 1, 0, 0, 0, 0, 0,
                    1, 0, 0, 0, 0, 0, 0, 0, 1,
                    1, 0, 0, 0, 1, 0, 1, 0, 0,
                    0, 0, 1, 0, 0, 0, 0, 1, 0]
}
